1111111111111111111111111
1001000000000000000000001
1001000322222222222200001
1001000100000000000010001
1001000100000000000010001
1002000200000000000040001
1001000100002220000404001
1001000338820002000000501
1001000033002220440000501
1001000003311111400000601
1001042220011011000007601
1001040070011011000077001
1001040070011011000080001
1001040070011111000070001
1001040070011111000070001
1001040000001010200000001
1001040010000100200000001
1001040003100000210000001
1001040031000000021000001
1001000310000000002100001
1001003100000000000210001
1001031000000000000021001
1001110000000000000002111
1000000000000000000000001
1111111111111111111111111