1111111111111111111111
1000000000000000000000
1000000222200000000000
1000000200000001230000
1000000000000000003200
1000005555000000003000
1000000000000000000000
1000001001000001002001
1112341100100000300000
1000000000000030004011
1000000000000000004030
1040000040044444000000
1000404000001
1000000400200000000000
1000222000030000555000
1000000000400000000000
1001112111141101020000
100100000000002
11010000000000066
116100000040002
1111111111234511111111
