1111111111111111111111
1000000000000000000000
1000000222200000000000
1000000200000001230000
1000000000000000003200
1000005555000000003000
1000000000000000000000
1000001001000001002001
1112341100100000300000
1000000000000030004011
1000000000000000004030
1040000040044444000000
1000404000001
1000000400200000000000
1000222000030000555000
1000000000400000000000
1001112111141101020000
1001000000000
1101000900400000000000
1161000000400000000000
1111999999234511111111
