111111111111111111111111111111111111111111111111
100000000000000000000000000000000000000000000001
10000002222000000000000000000030000000001111000000001
1000000200000001230000000400000000000000000000001
100000000000000000320000030000000000000200000000001
10000055550000000030000000002444400000000000001
10000000000000000000000000200000000000000000001
100000100100000100200123000000000000000001111111001
11123411001000003000000000000000000000000000000001
100000000000003000401111122223333344400000000000000000001
10000000000000000040300000000000001
104000004004444400000000000000000001
1000404000001
100000040020000000000000000400000000000000000000001
1000222000030000555000200000000334500000000000000001
100000000040000000000000000000000000001
100101201014010102000000000000000000000000111100101
1000000000000
1101000100400000000000003333330300000000000001
116100000040000000000000000000000000000000000001
111111111112345111111111000001111111111111111111
